64
....#........#..................#...#.#............#.#.........G
.............#.........................#............##.#.#......
...#....................................##............#...#.....
..#...........#...................#.......##...........#....##..
.............................................#..........##....#.
.#.............#...................#..........##.........##....#
#...................................#..........##.........#.....
................#...................#............##.......#.....
.................###...............................#..#...#.....
................#.#..#................#.............##.####.....
...............#....#...#...........###............##....###....
...............#......##.############.............#.....###.....
.....................#..#.......#.####...#...#..#.......#.......
..............#...#.........#.##.....#..#.#.............#.......
...........................#..#..#..##.#...#............#.......
..............#.#......#.....#.#.##...#.................##......
...............#....#......#.....#.#...#.....#...........#......
.................#.....#........#......#......##..........#.....
.#.#..#..#.#.##...........#...##...#...#..#.......#.......#.....
...................##..#..............##.....#.#..........#.....
............#...#.......................#.......##.#......#.....
............###.#.........#.......................#......#......
............#.#.........................##.........#.#..........
............##......................#.#.##.........#....#.......
...........#.##.#..#..#.......#..#.....##..........#..###.......
..............#.......#..#..........#...#.........#....#........
...........#.....................#......#...#...#.......##......
..........#........#....................#.#...#....#..#..##.....
............#.................#.......#................#....#...
..................................#...........#......#....#.##..
........#....#............#..............#..........#.........#.
..............#............................................#..##
....#.#..#...##..#..#..#......#....................#........#..#
..##...#...#.............#...........#..........#..#...........#
.#..........................##....................#..........#.#
.#...............#.#..#..........##..............#..............
..#...#........#...#.#...#.#.......#.............#...........#..
..#..######.....##........#..##.........#........##...........#.
....##.......#.##....#..........#..........#....#.............#.
.....###.......#..#...............#.............#..............#
.....##......#........#.#.#...................#.#...............
......#......#.##........#..........#..........#.#.#...........#
.....##..#...#...............#.................####.#.#..#.#..##
.....#.#......#........#........#......#............#.#........#
.....#.#.....##.#.....##...........#.#.................#.......#
......#...#.......#...............#...#.#..............#.......#
........#.....#...#.#.#....#...........#.###........####......##
.........#.......#..#.....#..#.##...#.....#.#.#...#...........#.
.............##....##.##...............#.......#....#.........#.
.........#......#.#..#........................##....#...........
.##........#.#####.#.#.##.#..#..#..#..#..#.###.....##...........
..###....##..###.....##...#......................##.............
..#.####.....#......#.........#.....#....#..#..#................
....####...#.#........#.#..................#.#..#...............
...#....##...#..#..........................#....#...............
....#.....##.#.............#.....................#....##........
............#.##....................................#......#.#.#
.....#..#######..#.#...#.......................#................
........#....###......##.......#.......................#........
......#.#......#####.......#....................................
.........#....#.#.#.#...............#...........#.......#.......
........###.....#..####........#................................
...........#..#.#..........#......#.....#................#......
S........#..#####......##............#....................#.....
