25
S........................
###......................
.###.....................
....###..................
.....###.................
.........................
.........................
####.....................
####.....................
####.....................
####.....................
..####...................
..####...................
..###....................
.........................
.........................
..###....................
.........................
..###....................
.........................
########.................
G......#.................
.......#.................
.........................
.........................