24
##################.....S
........................
#...##############.#.##.
##.##.##.##.##.##.#.....
##..####################
###.####################
###.####################
###.####################
###.####################
###.####################
###.####################
###.####################
###.####################
###.####################
###.####################
###.####################
###.####################
###.####################
###.####################
###.####################
###.####################
#.....##################
#.....##################
###....................G